Level4 "HARD"
3 4
3
2 3
3 6
5 3
FFWWWWWFF
WWWFFFWWF
WFFFWFFWF
WFFEFEFWW
WWEWFWFFW
FWFFFFFFW
FWWFFWWWW
FFWWWWFFF
