Level "Tutorial"
3 5
2
3 2
3 3
FFWWWWFF
FFWFFWFF
WWWFFWWW
WFFEEFFW
WFFFFFFW
WWWWWWWW